FIPS,County Name,Year,Structure Arsons,Mobile Arsons,Other Arsons,Total Arsons,Total Arsons Cleared
1,Alameda,1985,540,274,249,1063,160
1,Alameda,1986,428,304,155,887,144
1,Alameda,1987,453,275,170,898,172
1,Alameda,1988,373,259,164,796,127
1,Alameda,1989,348,301,193,842,152
1,Alameda,1990,299,269,239,807,108
1,Alameda,1991,413,330,202,945,187
1,Alameda,1992,434,337,123,894,114
1,Alameda,1993,372,263,151,786,81
1,Alameda,1994,389,185,166,740,76
1,Alameda,1995,189,85,112,386,73
1,Alameda,1996,332,296,140,768,72
1,Alameda,1997,249,266,157,672,77
1,Alameda,1998,220,271,108,599,50
1,Alameda,1999,232,270,78,580,50
1,Alameda,2000,222,259,91,572,58
1,Alameda,2001,228,324,129,681,71
1,Alameda,2002,204,368,115,687,62
1,Alameda,2003,184,348,108,640,44
1,Alameda,2004,187,265,90,542,46
1,Alameda,2005,236,201,108,545,31
1,Alameda,2006,189,298,109,596,47
1,Alameda,2007,200,262,95,557,66
1,Alameda,2008,150,307,85,542,65
1,Alameda,2009,148,233,76,457,39
1,Alameda,2010,118,178,96,392,47
1,Alameda,2011,113,139,41,293,18
1,Alameda,2012,174,109,54,337,31
1,Alameda,2013,130,109,71,310,42
1,Alameda,2014,111,158,57,326,32
1,Alameda,2015,133,149,60,342,36
1,Alameda,2016,178,144,49,371,44
1,Alameda,2017,207,162,70,439,63
1,Alameda,2018,210,175,59,444,66
1,Alameda,2019,171,157,53,381,38
3,Alpine,1985,0,0,0,0,0
3,Alpine,1986,0,0,0,0,0
3,Alpine,1987,0,0,0,0,0
3,Alpine,1988,0,0,0,0,0
3,Alpine,1989,0,0,0,0,0
3,Alpine,1990,0,0,0,0,0
3,Alpine,1991,0,0,0,0,0
3,Alpine,1992,0,0,0,0,0
3,Alpine,1993,0,0,0,0,0
3,Alpine,1994,0,0,0,0,0
3,Alpine,1995,0,0,0,0,0
3,Alpine,1996,0,0,0,0,0
3,Alpine,1997,0,0,0,0,0
3,Alpine,1998,0,0,0,0,0
3,Alpine,1999,0,0,0,0,0
3,Alpine,2000,0,0,0,0,0
3,Alpine,2001,0,0,0,0,0
3,Alpine,2002,0,0,0,0,0
3,Alpine,2003,0,0,0,0,0
3,Alpine,2004,0,0,0,0,0
3,Alpine,2005,0,0,0,0,0
3,Alpine,2006,0,0,0,0,0
3,Alpine,2007,0,0,0,0,0
3,Alpine,2008,0,0,0,0,0
3,Alpine,2009,0,0,0,0,0
3,Alpine,2010,0,0,0,0,0
3,Alpine,2011,0,0,0,0,0
3,Alpine,2012,0,0,0,0,0
3,Alpine,2013,0,0,0,0,0
3,Alpine,2014,0,0,0,0,0
3,Alpine,2015,0,0,0,0,0
3,Alpine,2016,0,0,0,0,0
3,Alpine,2017,0,0,0,0,0
3,Alpine,2018,0,0,0,0,0
3,Alpine,2019,0,0,0,0,0
5,Amador,1985,2,0,0,2,0
5,Amador,1986,3,2,0,5,0
5,Amador,1987,0,0,2,2,2
5,Amador,1988,3,2,30,35,1
5,Amador,1989,3,3,3,9,0
5,Amador,1990,2,0,1,3,1
5,Amador,1991,2,0,2,4,0
5,Amador,1992,0,0,1,1,1
5,Amador,1993,2,0,0,2,1
5,Amador,1994,0,0,0,0,0
5,Amador,1995,0,0,0,0,0
5,Amador,1996,0,1,0,1,0
5,Amador,1997,0,0,0,0,0
5,Amador,1998,1,1,0,2,1
5,Amador,1999,3,0,2,5,2
5,Amador,2000,2,1,1,4,1
5,Amador,2001,0,0,2,2,2
5,Amador,2002,0,0,1,1,1
5,Amador,2003,1,0,0,1,0
5,Amador,2004,1,0,0,1,0
5,Amador,2005,6,0,1,7,0
5,Amador,2006,5,0,1,6,1
5,Amador,2007,0,0,3,3,3
5,Amador,2008,2,0,2,4,2
5,Amador,2009,0,0,2,2,0
5,Amador,2010,1,0,2,3,1
5,Amador,2011,5,1,2,8,2
5,Amador,2012,2,0,0,2,2
5,Amador,2013,7,1,4,12,0
5,Amador,2014,4,0,0,4,0
5,Amador,2015,4,0,1,5,2
5,Amador,2016,4,0,0,4,1
5,Amador,2017,2,0,3,5,2
5,Amador,2018,7,0,0,7,4
5,Amador,2019,10,0,5,15,10
7,Butte,1985,33,20,66,119,4
7,Butte,1986,54,25,84,163,29
7,Butte,1987,29,21,155,205,21
7,Butte,1988,33,16,104,153,8
7,Butte,1989,31,19,76,126,2
7,Butte,1990,38,14,116,168,35
7,Butte,1991,52,28,127,207,22
7,Butte,1992,26,24,134,184,10
7,Butte,1993,32,23,114,169,17
7,Butte,1994,41,24,161,226,28
7,Butte,1995,38,23,164,225,23
7,Butte,1996,35,26,132,193,30
7,Butte,1997,23,18,86,127,13
7,Butte,1998,32,16,82,130,25
7,Butte,1999,42,17,111,170,35
7,Butte,2000,25,15,120,160,12
7,Butte,2001,19,41,166,226,19
7,Butte,2002,24,40,107,171,24
7,Butte,2003,38,38,135,211,25
7,Butte,2004,30,44,129,203,16
7,Butte,2005,15,33,89,137,11
7,Butte,2006,42,26,95,163,23
7,Butte,2007,14,25,83,122,19
7,Butte,2008,17,11,36,64,14
7,Butte,2009,29,14,38,81,19
7,Butte,2010,33,16,49,98,14
7,Butte,2011,12,10,27,49,17
7,Butte,2012,18,11,33,62,6
7,Butte,2013,21,1,33,55,10
7,Butte,2014,24,2,61,87,11
7,Butte,2015,16,8,180,204,7
7,Butte,2016,151,5,57,213,16
7,Butte,2017,145,4,25,174,8
7,Butte,2018,61,5,16,82,10
7,Butte,2019,42,5,28,75,21
9,Calaveras,1985,2,1,18,21,2
9,Calaveras,1986,4,7,86,97,1
9,Calaveras,1987,8,7,20,35,1
9,Calaveras,1988,6,5,28,39,0
9,Calaveras,1989,5,5,37,47,13
9,Calaveras,1990,4,2,14,20,5
9,Calaveras,1991,7,1,4,12,3
9,Calaveras,1992,14,1,55,70,3
9,Calaveras,1993,4,0,7,11,1
9,Calaveras,1994,1,1,31,33,0
9,Calaveras,1995,1,0,3,4,0
9,Calaveras,1996,3,1,14,18,0
9,Calaveras,1997,2,1,3,6,1
9,Calaveras,1998,2,0,0,2,0
9,Calaveras,1999,3,1,0,4,1
9,Calaveras,2000,5,1,19,25,1
9,Calaveras,2001,2,4,15,21,1
9,Calaveras,2002,2,0,3,5,0
9,Calaveras,2003,5,6,0,11,2
9,Calaveras,2004,6,0,0,6,3
9,Calaveras,2005,6,0,3,9,1
9,Calaveras,2006,4,0,3,7,3
9,Calaveras,2007,3,1,2,6,2
9,Calaveras,2008,3,0,1,4,1
9,Calaveras,2009,2,5,1,8,0
9,Calaveras,2010,2,0,0,2,1
9,Calaveras,2011,0,0,0,0,0
9,Calaveras,2012,1,0,1,2,1
9,Calaveras,2013,0,0,0,0,0
9,Calaveras,2014,0,0,2,2,0
9,Calaveras,2015,0,0,0,0,0
9,Calaveras,2016,0,0,0,0,0
9,Calaveras,2017,0,0,0,0,0
9,Calaveras,2018,0,0,0,0,0
9,Calaveras,2019,0,0,0,0,0
11,Colusa,1985,0,3,0,3,0
11,Colusa,1986,0,1,0,1,0
11,Colusa,1987,0,2,1,3,2
11,Colusa,1988,1,0,0,1,0
11,Colusa,1989,0,0,0,0,0
11,Colusa,1990,1,1,0,2,0
11,Colusa,1991,4,1,1,6,3
11,Colusa,1992,4,0,1,5,4
11,Colusa,1993,5,1,2,8,2
11,Colusa,1994,5,2,2,9,4
11,Colusa,1995,4,3,2,9,2
11,Colusa,1996,1,1,4,6,4
11,Colusa,1997,2,0,3,5,2
11,Colusa,1998,4,0,1,5,3
11,Colusa,1999,2,1,1,4,3
11,Colusa,2000,5,0,0,5,4
11,Colusa,2001,3,1,1,5,1
11,Colusa,2002,3,1,3,7,3
11,Colusa,2003,0,1,1,2,1
11,Colusa,2004,2,1,4,7,1
11,Colusa,2005,1,1,0,2,0
11,Colusa,2006,4,0,3,7,0
11,Colusa,2007,1,0,0,1,0
11,Colusa,2008,2,0,4,6,0
11,Colusa,2009,0,0,3,3,1
11,Colusa,2010,2,2,3,7,1
11,Colusa,2011,0,3,1,4,0
11,Colusa,2012,1,0,1,2,1
11,Colusa,2013,1,0,0,1,0
11,Colusa,2014,2,0,0,2,1
11,Colusa,2015,1,1,2,4,3
11,Colusa,2016,0,0,0,0,0
11,Colusa,2017,2,0,2,4,1
11,Colusa,2018,1,1,2,4,1
11,Colusa,2019,3,1,1,5,3
13,Contra Costa,1985,163,104,154,421,62
13,Contra Costa,1986,142,136,144,422,37
13,Contra Costa,1987,157,109,87,353,30
13,Contra Costa,1988,123,149,150,422,42
13,Contra Costa,1989,138,142,163,443,43
13,Contra Costa,1990,171,150,171,492,63
13,Contra Costa,1991,180,175,174,529,48
13,Contra Costa,1992,151,194,108,453,51
13,Contra Costa,1993,113,146,149,408,67
13,Contra Costa,1994,128,119,148,395,52
13,Contra Costa,1995,150,94,56,300,66
13,Contra Costa,1996,84,108,92,284,68
13,Contra Costa,1997,123,104,85,312,61
13,Contra Costa,1998,125,111,72,308,50
13,Contra Costa,1999,103,91,75,269,40
13,Contra Costa,2000,103,108,58,269,43
13,Contra Costa,2001,94,131,80,305,38
13,Contra Costa,2002,70,135,92,297,38
13,Contra Costa,2003,81,85,51,217,30
13,Contra Costa,2004,79,74,47,200,31
13,Contra Costa,2005,64,65,69,198,27
13,Contra Costa,2006,84,59,95,238,42
13,Contra Costa,2007,102,66,83,251,36
13,Contra Costa,2008,93,69,38,200,21
13,Contra Costa,2009,79,76,58,213,25
13,Contra Costa,2010,66,70,60,196,23
13,Contra Costa,2011,62,52,68,182,28
13,Contra Costa,2012,46,47,71,164,13
13,Contra Costa,2013,55,60,36,151,13
13,Contra Costa,2014,49,58,46,153,18
13,Contra Costa,2015,57,52,45,154,25
13,Contra Costa,2016,63,80,56,199,28
13,Contra Costa,2017,76,96,60,232,27
13,Contra Costa,2018,50,97,66,213,32
13,Contra Costa,2019,84,71,53,208,78
15,Del Norte,1985,9,0,2,11,2
15,Del Norte,1986,7,1,0,8,3
15,Del Norte,1987,6,2,4,12,3
15,Del Norte,1988,5,1,4,10,3
15,Del Norte,1989,5,6,1,12,3
15,Del Norte,1990,9,1,1,11,2
15,Del Norte,1991,2,1,0,3,0
15,Del Norte,1992,3,2,0,5,0
15,Del Norte,1993,2,0,1,3,4
15,Del Norte,1994,0,0,0,0,0
15,Del Norte,1995,3,0,1,4,1
15,Del Norte,1996,3,2,3,8,4
15,Del Norte,1997,2,1,1,4,2
15,Del Norte,1998,6,0,1,7,4
15,Del Norte,1999,6,4,0,10,0
15,Del Norte,2000,2,2,0,4,0
15,Del Norte,2001,3,1,3,7,2
15,Del Norte,2002,4,0,1,5,3
15,Del Norte,2003,0,2,4,6,1
15,Del Norte,2004,4,2,4,10,4
15,Del Norte,2005,0,1,0,1,0
15,Del Norte,2006,4,0,1,5,0
15,Del Norte,2007,3,1,0,4,2
15,Del Norte,2008,2,2,1,5,1
15,Del Norte,2009,3,1,1,5,0
15,Del Norte,2010,1,2,2,5,1
15,Del Norte,2011,2,4,0,6,0
15,Del Norte,2012,1,1,4,6,2
15,Del Norte,2013,7,3,1,11,2
15,Del Norte,2014,2,4,1,7,2
15,Del Norte,2015,5,4,5,14,4
15,Del Norte,2016,1,1,5,7,0
15,Del Norte,2017,5,8,6,19,0
15,Del Norte,2018,2,1,6,9,1
15,Del Norte,2019,3,0,15,18,2
17,El Dorado,1985,18,4,8,30,6
17,El Dorado,1986,14,10,7,31,7
17,El Dorado,1987,17,4,5,26,5
17,El Dorado,1988,20,4,8,32,12
17,El Dorado,1989,17,5,6,28,7
17,El Dorado,1990,17,6,20,43,16
17,El Dorado,1991,17,6,5,28,4
17,El Dorado,1992,13,7,4,24,9
17,El Dorado,1993,14,2,6,22,7
17,El Dorado,1994,18,5,15,38,14
17,El Dorado,1995,16,4,6,26,7
17,El Dorado,1996,14,4,6,24,3
17,El Dorado,1997,11,2,9,22,4
17,El Dorado,1998,10,5,3,18,5
17,El Dorado,1999,15,3,7,25,7
17,El Dorado,2000,13,4,8,25,6
17,El Dorado,2001,11,2,4,17,2
17,El Dorado,2002,13,1,8,22,11
17,El Dorado,2003,11,6,4,21,7
17,El Dorado,2004,6,2,4,12,2
17,El Dorado,2005,5,5,3,13,2
17,El Dorado,2006,9,2,3,14,2
17,El Dorado,2007,8,5,10,23,9
17,El Dorado,2008,9,6,10,25,4
17,El Dorado,2009,14,1,2,17,7
17,El Dorado,2010,10,0,2,12,1
17,El Dorado,2011,7,4,2,13,6
17,El Dorado,2012,7,2,3,12,6
17,El Dorado,2013,2,1,3,6,0
17,El Dorado,2014,5,1,7,13,4
17,El Dorado,2015,3,0,1,4,4
17,El Dorado,2016,3,1,4,8,5
17,El Dorado,2017,0,0,5,5,2
17,El Dorado,2018,8,2,4,14,2
17,El Dorado,2019,3,1,0,4,2
19,Fresno,1985,148,237,230,615,64
19,Fresno,1986,142,204,120,466,60
19,Fresno,1987,149,152,72,373,57
19,Fresno,1988,120,94,48,262,51
19,Fresno,1989,147,124,55,326,79
19,Fresno,1990,124,165,89,378,75
19,Fresno,1991,200,228,133,561,94
19,Fresno,1992,175,362,197,734,87
19,Fresno,1993,209,349,194,752,68
19,Fresno,1994,273,409,351,1033,128
19,Fresno,1995,284,385,768,1437,108
19,Fresno,1996,218,341,671,1230,124
19,Fresno,1997,221,328,673,1222,96
19,Fresno,1998,207,396,530,1133,79
19,Fresno,1999,198,429,443,1070,68
19,Fresno,2000,201,466,294,961,53
19,Fresno,2001,196,513,419,1128,98
19,Fresno,2002,173,567,476,1216,80
19,Fresno,2003,139,537,378,1054,55
19,Fresno,2004,148,387,268,803,56
19,Fresno,2005,134,256,163,553,62
19,Fresno,2006,143,366,129,638,54
19,Fresno,2007,148,230,88,466,55
19,Fresno,2008,130,320,121,571,54
19,Fresno,2009,122,271,98,491,41
19,Fresno,2010,89,259,100,448,33
19,Fresno,2011,72,149,97,318,39
19,Fresno,2012,97,205,113,415,37
19,Fresno,2013,114,159,133,406,76
19,Fresno,2014,123,171,197,491,46
19,Fresno,2015,101,179,175,455,59
19,Fresno,2016,110,199,165,474,65
19,Fresno,2017,136,181,207,524,78
19,Fresno,2018,87,183,176,446,79
19,Fresno,2019,64,137,73,274,28
21,Glenn,1985,2,0,0,2,0
21,Glenn,1986,2,0,1,3,1
21,Glenn,1987,1,0,0,1,0
21,Glenn,1988,4,2,1,7,6
21,Glenn,1989,2,0,0,2,1
21,Glenn,1990,2,0,0,2,0
21,Glenn,1991,1,0,0,1,0
21,Glenn,1992,1,2,0,3,0
21,Glenn,1993,6,1,2,9,4
21,Glenn,1994,5,1,3,9,2
21,Glenn,1995,5,3,1,9,2
21,Glenn,1996,8,4,6,18,4
21,Glenn,1997,9,9,5,23,3
21,Glenn,1998,4,5,1,10,2
21,Glenn,1999,6,19,1,26,3
21,Glenn,2000,1,5,0,6,0
21,Glenn,2001,1,5,1,7,1
21,Glenn,2002,2,2,0,4,2
21,Glenn,2003,1,1,2,4,3
21,Glenn,2004,0,1,1,2,1
21,Glenn,2005,0,2,2,4,0
21,Glenn,2006,2,2,0,4,2
21,Glenn,2007,2,0,0,2,1
21,Glenn,2008,2,1,1,4,1
21,Glenn,2009,0,0,0,0,0
21,Glenn,2010,1,1,1,3,1
21,Glenn,2011,2,3,0,5,2
21,Glenn,2012,3,1,3,7,5
21,Glenn,2013,1,1,2,4,0
21,Glenn,2014,2,4,3,9,1
21,Glenn,2015,0,0,4,4,0
21,Glenn,2016,4,4,1,9,0
21,Glenn,2017,3,0,2,5,1
21,Glenn,2018,0,2,1,3,0
21,Glenn,2019,1,0,2,3,0
23,Humboldt,1985,37,16,86,139,14
23,Humboldt,1986,30,9,16,55,8
23,Humboldt,1987,37,5,5,47,9
23,Humboldt,1988,34,10,5,49,11
23,Humboldt,1989,28,12,19,59,11
23,Humboldt,1990,25,12,5,42,12
23,Humboldt,1991,41,13,9,63,11
23,Humboldt,1992,42,15,16,73,21
23,Humboldt,1993,29,15,21,65,17
23,Humboldt,1994,26,10,6,42,2
23,Humboldt,1995,31,13,16,60,8
23,Humboldt,1996,27,9,13,49,12
23,Humboldt,1997,30,17,8,55,13
23,Humboldt,1998,34,12,9,55,6
23,Humboldt,1999,30,16,15,61,17
23,Humboldt,2000,28,13,18,59,5
23,Humboldt,2001,37,16,25,78,16
23,Humboldt,2002,38,24,12,74,11
23,Humboldt,2003,36,19,17,72,11
23,Humboldt,2004,26,12,15,53,20
23,Humboldt,2005,16,14,7,37,5
23,Humboldt,2006,11,15,9,35,8
23,Humboldt,2007,12,11,7,30,7
23,Humboldt,2008,20,10,10,40,8
23,Humboldt,2009,28,13,10,51,5
23,Humboldt,2010,26,14,24,64,13
23,Humboldt,2011,25,8,22,55,10
23,Humboldt,2012,27,9,12,48,8
23,Humboldt,2013,25,7,24,56,10
23,Humboldt,2014,34,13,18,65,6
23,Humboldt,2015,49,5,13,67,10
23,Humboldt,2016,21,2,13,36,5
23,Humboldt,2017,43,6,16,65,14
23,Humboldt,2018,41,3,23,67,15
23,Humboldt,2019,62,1,8,71,12
25,Imperial,1985,24,23,20,67,16
25,Imperial,1986,23,25,19,67,8
25,Imperial,1987,10,20,28,58,13
25,Imperial,1988,19,11,25,55,6
25,Imperial,1989,17,15,15,47,7
25,Imperial,1990,24,22,148,194,13
25,Imperial,1991,27,18,101,146,17
25,Imperial,1992,28,30,45,103,9
25,Imperial,1993,28,29,55,112,22
25,Imperial,1994,44,25,30,99,13
25,Imperial,1995,29,23,52,104,53
25,Imperial,1996,30,16,14,60,13
25,Imperial,1997,15,20,25,60,6
25,Imperial,1998,15,8,14,37,11
25,Imperial,1999,8,7,12,27,3
25,Imperial,2000,12,11,24,47,2
25,Imperial,2001,27,11,23,61,1
25,Imperial,2002,21,11,27,59,8
25,Imperial,2003,19,9,27,55,11
25,Imperial,2004,16,7,26,49,8
25,Imperial,2005,29,15,49,93,12
25,Imperial,2006,21,14,47,82,6
25,Imperial,2007,11,7,10,28,3
25,Imperial,2008,14,9,18,41,6
25,Imperial,2009,15,9,20,44,6
25,Imperial,2010,16,12,11,39,8
25,Imperial,2011,11,5,16,32,7
25,Imperial,2012,12,5,11,28,4
25,Imperial,2013,19,5,26,50,9
25,Imperial,2014,23,6,17,46,5
25,Imperial,2015,22,8,41,71,11
25,Imperial,2016,21,13,24,58,11
25,Imperial,2017,22,13,45,80,16
25,Imperial,2018,29,6,55,90,20
25,Imperial,2019,29,11,64,104,18
27,Inyo,1985,3,2,3,8,3
27,Inyo,1986,1,0,0,1,1
27,Inyo,1987,2,1,0,3,1
27,Inyo,1988,2,0,0,2,2
27,Inyo,1989,3,0,1,4,2
27,Inyo,1990,5,8,2,15,3
27,Inyo,1991,3,3,3,9,9
27,Inyo,1992,4,3,1,8,2
27,Inyo,1993,2,1,2,5,1
27,Inyo,1994,1,2,3,6,0
27,Inyo,1995,2,0,5,7,0
27,Inyo,1996,3,0,2,5,1
27,Inyo,1997,0,1,1,2,1
27,Inyo,1998,4,0,2,6,3
27,Inyo,1999,3,1,1,5,0
27,Inyo,2000,5,2,0,7,1
27,Inyo,2001,1,0,2,3,0
27,Inyo,2002,2,1,8,11,1
27,Inyo,2003,3,0,2,5,1
27,Inyo,2004,0,0,0,0,0
27,Inyo,2005,2,0,1,3,1
27,Inyo,2006,4,0,0,4,2
27,Inyo,2007,2,0,0,2,2
27,Inyo,2008,4,0,0,4,0
27,Inyo,2009,1,0,0,1,0
27,Inyo,2010,5,0,2,7,1
27,Inyo,2011,0,0,5,5,1
27,Inyo,2012,0,0,0,0,0
27,Inyo,2013,1,0,0,1,1
27,Inyo,2014,2,0,0,2,0
27,Inyo,2015,0,0,0,0,0
27,Inyo,2016,0,0,1,1,0
27,Inyo,2017,2,1,0,3,2
27,Inyo,2018,2,0,1,3,0
27,Inyo,2019,0,0,0,0,0
29,Kern,1985,194,139,662,995,180
29,Kern,1986,209,183,741,1133,174
29,Kern,1987,221,122,600,943,180
29,Kern,1988,219,130,618,967,207
29,Kern,1989,210,82,659,951,140
29,Kern,1990,311,124,451,886,40
29,Kern,1991,334,128,455,917,39
29,Kern,1992,376,136,619,1131,57
29,Kern,1993,344,126,884,1354,48
29,Kern,1994,240,131,886,1257,102
29,Kern,1995,260,160,950,1370,61
29,Kern,1996,248,130,1124,1502,75
29,Kern,1997,209,136,904,1249,53
29,Kern,1998,243,155,836,1234,39
29,Kern,1999,218,124,893,1235,67
29,Kern,2000,229,224,704,1157,42
29,Kern,2001,264,246,263,773,68
29,Kern,2002,252,281,113,646,31
29,Kern,2003,184,279,80,543,28
29,Kern,2004,184,248,123,555,42
29,Kern,2005,191,245,104,540,54
29,Kern,2006,200,284,107,591,55
29,Kern,2007,172,273,69,514,30
29,Kern,2008,229,312,168,709,37
29,Kern,2009,169,281,143,593,41
29,Kern,2010,175,218,139,532,30
29,Kern,2011,155,189,169,513,40
29,Kern,2012,238,203,148,589,55
29,Kern,2013,230,219,96,545,48
29,Kern,2014,302,210,134,646,60
29,Kern,2015,326,217,171,714,72
29,Kern,2016,316,227,152,695,51
29,Kern,2017,316,224,152,692,74
29,Kern,2018,324,253,138,715,88
29,Kern,2019,412,252,179,843,80
31,Kings,1985,16,6,7,29,5
31,Kings,1986,22,6,5,33,4
31,Kings,1987,18,5,7,30,8
31,Kings,1988,11,8,7,26,11
31,Kings,1989,22,10,11,43,17
31,Kings,1990,19,8,8,35,8
31,Kings,1991,14,4,5,23,4
31,Kings,1992,16,12,10,38,12
31,Kings,1993,20,11,8,39,10
31,Kings,1994,13,9,12,34,12
31,Kings,1995,24,4,7,35,9
31,Kings,1996,25,11,23,59,19
31,Kings,1997,22,5,10,37,4
31,Kings,1998,13,4,3,20,6
31,Kings,1999,5,3,6,14,2
31,Kings,2000,10,9,8,27,4
31,Kings,2001,10,4,6,20,5
31,Kings,2002,20,10,14,44,14
31,Kings,2003,14,10,9,33,5
31,Kings,2004,20,6,8,34,16
31,Kings,2005,16,6,11,33,7
31,Kings,2006,24,21,25,70,9
31,Kings,2007,21,17,14,52,21
31,Kings,2008,14,15,19,48,10
31,Kings,2009,12,10,8,30,9
31,Kings,2010,11,14,10,35,4
31,Kings,2011,9,9,16,34,4
31,Kings,2012,22,6,6,34,8
31,Kings,2013,13,5,11,29,4
31,Kings,2014,13,1,5,19,7
31,Kings,2015,17,5,5,27,9
31,Kings,2016,15,3,3,21,7
31,Kings,2017,25,2,4,31,13
31,Kings,2018,9,5,3,17,5
31,Kings,2019,17,4,6,27,8
33,Lake,1985,15,3,6,24,7
33,Lake,1986,15,3,1,19,3
33,Lake,1987,17,4,1,22,4
33,Lake,1988,8,4,1,13,4
33,Lake,1989,13,3,0,16,3
33,Lake,1990,5,1,1,7,3
33,Lake,1991,3,3,4,10,2
33,Lake,1992,0,2,3,5,2
33,Lake,1993,6,2,5,13,0
33,Lake,1994,7,2,5,14,4
33,Lake,1995,3,2,1,6,1
33,Lake,1996,4,5,3,12,5
33,Lake,1997,7,7,5,19,4
33,Lake,1998,7,1,6,14,3
33,Lake,1999,11,6,7,24,3
33,Lake,2000,8,1,5,14,7
33,Lake,2001,3,1,2,6,0
33,Lake,2002,6,2,2,10,2
33,Lake,2003,5,2,6,13,8
33,Lake,2004,6,5,6,17,7
33,Lake,2005,6,7,4,17,11
33,Lake,2006,12,3,5,20,9
33,Lake,2007,24,1,0,25,7
33,Lake,2008,18,2,0,20,7
33,Lake,2009,9,0,0,9,3
33,Lake,2010,9,1,0,10,2
33,Lake,2011,22,3,0,25,6
33,Lake,2012,25,0,0,25,9
33,Lake,2013,17,0,4,21,10
33,Lake,2014,21,0,1,22,7
33,Lake,2015,17,0,2,19,3
33,Lake,2016,20,0,1,21,2
33,Lake,2017,31,0,0,31,23
33,Lake,2018,15,0,2,17,10
33,Lake,2019,14,0,2,16,8
35,Lassen,1985,2,0,1,3,2
35,Lassen,1986,5,0,0,5,2
35,Lassen,1987,2,1,1,4,1
35,Lassen,1988,1,4,0,5,3
35,Lassen,1989,0,0,0,0,0
35,Lassen,1990,2,2,0,4,2
35,Lassen,1991,0,0,0,0,0
35,Lassen,1992,3,0,0,3,1
35,Lassen,1993,2,2,3,7,1
35,Lassen,1994,11,2,6,19,9
35,Lassen,1995,0,1,2,3,1
35,Lassen,1996,3,0,2,5,2
35,Lassen,1997,2,3,2,7,3
35,Lassen,1998,4,0,2,6,4
35,Lassen,1999,3,1,3,7,4
35,Lassen,2000,2,0,3,5,2
35,Lassen,2001,6,0,0,6,3
35,Lassen,2002,5,1,4,10,5
35,Lassen,2003,3,0,4,7,6
35,Lassen,2004,2,1,0,3,1
35,Lassen,2005,5,3,3,11,2
35,Lassen,2006,3,0,2,5,3
35,Lassen,2007,3,0,2,5,5
35,Lassen,2008,0,1,4,5,2
35,Lassen,2009,7,1,3,11,5
35,Lassen,2010,1,0,3,4,3
35,Lassen,2011,0,2,3,5,3
35,Lassen,2012,5,3,1,9,7
35,Lassen,2013,5,1,3,9,7
35,Lassen,2014,3,1,0,4,2
35,Lassen,2015,6,0,3,9,8
35,Lassen,2016,1,1,2,4,4
35,Lassen,2017,6,0,4,10,7
35,Lassen,2018,3,5,2,10,9
35,Lassen,2019,1,0,0,1,1
37,Los Angeles,1985,3328,2376,2853,8557,711
37,Los Angeles,1986,2887,2599,2774,8260,650
37,Los Angeles,1987,2981,2606,2783,8370,619
37,Los Angeles,1988,3104,2739,2998,8841,616
37,Los Angeles,1989,2716,2614,3305,8635,563
37,Los Angeles,1990,2685,2814,3275,8774,689
37,Los Angeles,1991,2560,2776,2821,8157,639
37,Los Angeles,1992,3935,3060,2925,9920,641
37,Los Angeles,1993,2519,2591,3071,8181,593
37,Los Angeles,1994,2350,2072,2502,6924,556
37,Los Angeles,1995,1834,1813,1784,5431,501
37,Los Angeles,1996,1763,1878,2037,5678,473
37,Los Angeles,1997,1597,1820,1737,5154,473
37,Los Angeles,1998,1377,1527,1351,4255,423
37,Los Angeles,1999,1356,1453,1345,4154,374
37,Los Angeles,2000,1309,1557,1405,4271,306
37,Los Angeles,2001,1250,1821,1340,4411,242
37,Los Angeles,2002,1114,1788,1265,4167,260
37,Los Angeles,2003,950,1858,1191,3999,197
37,Los Angeles,2004,949,1552,1181,3682,229
37,Los Angeles,2005,1052,1453,1278,3783,309
37,Los Angeles,2006,947,1416,1438,3801,245
37,Los Angeles,2007,907,1458,1388,3753,371
37,Los Angeles,2008,910,1408,1053,3371,242
37,Los Angeles,2009,624,1132,1059,2815,248
37,Los Angeles,2010,532,757,962,2251,227
37,Los Angeles,2011,493,685,1111,2289,214
37,Los Angeles,2012,517,589,1228,2334,270
37,Los Angeles,2013,506,491,1264,2261,236
37,Los Angeles,2014,431,494,1043,1968,288
37,Los Angeles,2015,511,558,1010,2079,304
37,Los Angeles,2016,558,570,1232,2360,292
37,Los Angeles,2017,602,545,1382,2529,354
37,Los Angeles,2018,557,497,1630,2684,382
37,Los Angeles,2019,564,463,1684,2711,371
39,Madera,1985,8,19,6,33,3
39,Madera,1986,7,20,17,44,2
39,Madera,1987,14,7,2,23,2
39,Madera,1988,12,12,5,29,3
39,Madera,1989,12,13,8,33,1
39,Madera,1990,5,30,5,40,4
39,Madera,1991,24,40,34,98,3
39,Madera,1992,13,42,78,133,8
39,Madera,1993,10,35,29,74,3
39,Madera,1994,6,37,36,79,19
39,Madera,1995,10,70,14,94,5
39,Madera,1996,9,79,12,100,2
39,Madera,1997,14,117,9,140,13
39,Madera,1998,5,110,13,128,3
39,Madera,1999,7,20,5,32,1
39,Madera,2000,13,9,2,24,3
39,Madera,2001,9,5,10,24,3
39,Madera,2002,15,11,15,41,6
39,Madera,2003,13,4,15,32,4
39,Madera,2004,4,4,5,13,3
39,Madera,2005,4,5,12,21,3
39,Madera,2006,1,0,0,1,0
39,Madera,2007,1,1,3,5,1
39,Madera,2008,3,3,5,11,5
39,Madera,2009,11,1,6,18,0
39,Madera,2010,4,0,3,7,1
39,Madera,2011,18,1,3,22,1
39,Madera,2012,8,2,1,11,0
39,Madera,2013,4,3,4,11,6
39,Madera,2014,9,7,8,24,8
39,Madera,2015,8,6,1,15,5
39,Madera,2016,6,3,8,17,3
39,Madera,2017,9,8,15,32,3
39,Madera,2018,17,7,3,27,3
39,Madera,2019,10,6,8,24,4
41,Marin,1985,26,14,31,71,17
41,Marin,1986,35,13,25,73,13
41,Marin,1987,17,14,11,42,6
41,Marin,1988,27,14,23,64,12
41,Marin,1989,22,22,28,72,25
41,Marin,1990,27,15,25,67,14
41,Marin,1991,22,15,32,69,15
41,Marin,1992,26,10,18,54,6
41,Marin,1993,31,13,19,63,14
41,Marin,1994,24,5,37,66,10
41,Marin,1995,41,5,19,65,11
41,Marin,1996,16,12,7,35,8
41,Marin,1997,10,11,8,29,11
41,Marin,1998,13,7,7,27,8
41,Marin,1999,19,4,9,32,5
41,Marin,2000,10,4,14,28,11
41,Marin,2001,18,6,26,50,10
41,Marin,2002,18,10,24,52,6
41,Marin,2003,11,4,26,41,4
41,Marin,2004,13,1,32,46,7
41,Marin,2005,20,3,26,49,14
41,Marin,2006,28,4,18,50,9
41,Marin,2007,33,4,24,61,12
41,Marin,2008,24,4,23,51,9
41,Marin,2009,21,2,16,39,7
41,Marin,2010,20,2,8,30,8
41,Marin,2011,15,1,15,31,5
41,Marin,2012,19,1,22,42,7
41,Marin,2013,18,0,27,45,8
41,Marin,2014,15,1,34,50,10
41,Marin,2015,17,2,17,36,9
41,Marin,2016,7,1,15,23,7
41,Marin,2017,16,0,11,27,6
41,Marin,2018,13,2,15,30,11
41,Marin,2019,8,2,8,18,7
43,Mariposa,1985,4,0,29,33,0
43,Mariposa,1986,3,0,17,20,0
43,Mariposa,1987,1,0,0,1,0
43,Mariposa,1988,5,3,4,12,0
43,Mariposa,1989,2,1,2,5,1
43,Mariposa,1990,1,1,2,4,0
43,Mariposa,1991,0,0,0,0,0
43,Mariposa,1992,0,0,1,1,1
43,Mariposa,1993,0,0,0,0,0
43,Mariposa,1994,2,0,0,2,1
43,Mariposa,1995,0,0,1,1,1
43,Mariposa,1996,3,0,2,5,3
43,Mariposa,1997,0,1,0,1,0
43,Mariposa,1998,1,1,0,2,1
43,Mariposa,1999,2,0,0,2,1
43,Mariposa,2000,2,0,2,4,3
43,Mariposa,2001,0,3,2,5,3
43,Mariposa,2002,2,1,0,3,2
43,Mariposa,2003,0,0,0,0,0
43,Mariposa,2004,2,0,1,3,2
43,Mariposa,2005,2,1,0,3,1
43,Mariposa,2006,1,2,0,3,2
43,Mariposa,2007,0,0,0,0,0
43,Mariposa,2008,2,0,0,2,1
43,Mariposa,2009,0,1,0,1,0
43,Mariposa,2010,1,0,0,1,0
43,Mariposa,2011,1,0,0,1,1
43,Mariposa,2012,0,0,0,0,0
43,Mariposa,2013,0,0,0,0,0
43,Mariposa,2014,0,0,0,0,0
43,Mariposa,2015,0,0,0,0,0
43,Mariposa,2016,0,0,0,0,0
43,Mariposa,2017,0,0,0,0,0
43,Mariposa,2018,0,0,0,0,0
43,Mariposa,2019,0,0,0,0,0
45,Mendocino,1985,15,3,8,26,10
45,Mendocino,1986,15,5,9,29,10
45,Mendocino,1987,21,4,4,29,11
45,Mendocino,1988,24,8,5,37,9
45,Mendocino,1989,14,8,4,26,6
45,Mendocino,1990,14,4,2,20,8
45,Mendocino,1991,12,10,5,27,9
45,Mendocino,1992,22,6,7,35,5
45,Mendocino,1993,16,7,10,33,6
45,Mendocino,1994,23,7,10,40,9
45,Mendocino,1995,21,6,5,32,7
45,Mendocino,1996,16,4,14,34,9
45,Mendocino,1997,15,2,6,23,5
45,Mendocino,1998,17,8,13,38,7
45,Mendocino,1999,22,9,11,42,14
45,Mendocino,2000,18,9,15,42,14
45,Mendocino,2001,23,11,19,53,14
45,Mendocino,2002,17,3,4,24,7
45,Mendocino,2003,15,3,8,26,6
45,Mendocino,2004,14,5,10,29,11
45,Mendocino,2005,19,6,13,38,10
45,Mendocino,2006,14,8,6,28,9
45,Mendocino,2007,7,9,7,23,4
45,Mendocino,2008,12,7,5,24,6
45,Mendocino,2009,10,6,6,22,6
45,Mendocino,2010,14,4,7,25,11
45,Mendocino,2011,12,3,4,19,10
45,Mendocino,2012,29,6,3,38,7
45,Mendocino,2013,21,8,4,33,8
45,Mendocino,2014,11,7,8,26,8
45,Mendocino,2015,10,7,5,22,8
45,Mendocino,2016,4,1,3,8,4
45,Mendocino,2017,12,2,12,26,9
45,Mendocino,2018,22,8,19,49,12
45,Mendocino,2019,20,8,16,44,10
47,Merced,1985,19,13,10,42,10
47,Merced,1986,25,9,4,38,9
47,Merced,1987,25,9,8,42,10
47,Merced,1988,21,14,5,40,13
47,Merced,1989,22,16,14,52,13
47,Merced,1990,21,23,20,64,29
47,Merced,1991,20,13,26,59,21
47,Merced,1992,32,17,12,61,20
47,Merced,1993,40,22,10,72,9
47,Merced,1994,29,20,9,58,10
47,Merced,1995,20,11,17,48,11
47,Merced,1996,65,64,60,189,17
47,Merced,1997,41,29,17,87,20
47,Merced,1998,26,27,27,80,9
47,Merced,1999,48,18,22,88,25
47,Merced,2000,27,14,22,63,15
47,Merced,2001,46,19,10,75,11
47,Merced,2002,30,16,36,82,13
47,Merced,2003,35,28,19,82,14
47,Merced,2004,35,22,25,82,11
47,Merced,2005,33,16,42,91,18
47,Merced,2006,41,24,34,99,19
47,Merced,2007,43,23,26,92,13
47,Merced,2008,47,15,24,86,23
47,Merced,2009,41,26,23,90,13
47,Merced,2010,25,10,25,60,14
47,Merced,2011,22,12,34,68,8
47,Merced,2012,42,15,26,83,18
47,Merced,2013,49,7,69,125,21
47,Merced,2014,30,7,26,63,10
47,Merced,2015,48,19,46,113,22
47,Merced,2016,49,18,50,117,21
47,Merced,2017,58,16,58,132,40
47,Merced,2018,40,14,46,100,23
47,Merced,2019,41,14,34,89,18
49,Modoc,1985,1,3,0,4,2
49,Modoc,1986,1,1,0,2,2
49,Modoc,1987,1,1,0,2,0
49,Modoc,1988,1,1,1,3,1
49,Modoc,1989,0,1,0,1,0
49,Modoc,1990,0,1,0,1,0
49,Modoc,1991,2,0,1,3,1
49,Modoc,1992,6,0,2,8,4
49,Modoc,1993,0,0,1,1,0
49,Modoc,1994,2,0,3,5,2
49,Modoc,1995,4,0,2,6,2
49,Modoc,1996,3,0,1,4,3
49,Modoc,1997,6,0,0,6,5
49,Modoc,1998,2,0,1,3,2
49,Modoc,1999,0,0,1,1,1
49,Modoc,2000,1,0,1,2,1
49,Modoc,2001,0,0,0,0,0
49,Modoc,2002,3,1,2,6,5
49,Modoc,2003,2,0,2,4,4
49,Modoc,2004,1,0,0,1,1
49,Modoc,2005,2,0,1,3,2
49,Modoc,2006,1,1,1,3,1
49,Modoc,2007,1,0,2,3,0
49,Modoc,2008,2,0,1,3,1
49,Modoc,2009,0,1,0,1,0
49,Modoc,2010,1,1,1,3,0
49,Modoc,2011,4,2,1,7,2
49,Modoc,2012,3,0,2,5,1
49,Modoc,2013,0,0,2,2,2
49,Modoc,2014,0,0,1,1,0
49,Modoc,2015,4,0,0,4,2
49,Modoc,2016,0,0,0,0,0
49,Modoc,2017,1,0,1,2,2
49,Modoc,2018,2,0,0,2,2
49,Modoc,2019,0,0,0,0,0
51,Mono,1985,0,0,1,1,0
51,Mono,1986,4,0,0,4,1
51,Mono,1987,0,1,0,1,0
51,Mono,1988,3,1,1,5,4
51,Mono,1989,1,1,0,2,2
51,Mono,1990,3,0,1,4,0
51,Mono,1991,2,0,0,2,0
51,Mono,1992,0,1,0,1,0
51,Mono,1993,0,0,0,0,0
51,Mono,1994,0,0,2,2,0
51,Mono,1995,2,2,2,6,2
51,Mono,1996,1,0,0,1,1
51,Mono,1997,2,0,0,2,0
51,Mono,1998,4,0,0,4,2
51,Mono,1999,1,1,0,2,0
51,Mono,2000,2,1,0,3,0
51,Mono,2001,1,0,1,2,0
51,Mono,2002,0,1,1,2,2
51,Mono,2003,0,0,0,0,0
51,Mono,2004,0,0,0,0,0
51,Mono,2005,0,0,0,0,0
51,Mono,2006,0,0,0,0,0
51,Mono,2007,1,0,0,1,0
51,Mono,2008,0,0,0,0,0
51,Mono,2009,1,0,0,1,0
51,Mono,2010,1,0,1,2,1
51,Mono,2011,0,0,1,1,0
51,Mono,2012,0,0,1,1,1
51,Mono,2013,1,0,0,1,1
51,Mono,2014,0,0,0,0,0
51,Mono,2015,0,0,0,0,0
51,Mono,2016,0,0,0,0,0
51,Mono,2017,0,0,0,0,0
51,Mono,2018,2,0,0,2,1
51,Mono,2019,3,0,0,3,2
53,Monterey,1985,66,39,73,178,24
53,Monterey,1986,41,55,76,172,21
53,Monterey,1987,59,69,66,194,31
53,Monterey,1988,48,44,70,162,15
53,Monterey,1989,88,37,46,171,57
53,Monterey,1990,80,42,73,195,49
53,Monterey,1991,74,60,70,204,23
53,Monterey,1992,82,70,108,260,27
53,Monterey,1993,111,67,106,284,64
53,Monterey,1994,59,49,67,175,26
53,Monterey,1995,60,39,37,136,21
53,Monterey,1996,52,42,31,125,17
53,Monterey,1997,36,32,20,88,14
53,Monterey,1998,36,41,18,95,10
53,Monterey,1999,22,32,25,79,11
53,Monterey,2000,46,43,36,125,14
53,Monterey,2001,34,53,38,125,19
53,Monterey,2002,37,50,30,117,14
53,Monterey,2003,30,42,34,106,10
53,Monterey,2004,19,35,20,74,3
53,Monterey,2005,26,37,28,91,15
53,Monterey,2006,28,31,22,81,13
53,Monterey,2007,24,33,22,79,14
53,Monterey,2008,26,30,22,78,16
53,Monterey,2009,31,40,19,90,11
53,Monterey,2010,24,34,10,68,4
53,Monterey,2011,29,34,22,85,14
53,Monterey,2012,19,17,28,64,20
53,Monterey,2013,16,14,30,60,7
53,Monterey,2014,27,36,19,82,7
53,Monterey,2015,21,24,11,56,14
53,Monterey,2016,19,15,8,42,13
53,Monterey,2017,27,17,14,58,16
53,Monterey,2018,18,21,16,55,15
53,Monterey,2019,32,21,18,71,13
55,Napa,1985,13,4,17,34,6
55,Napa,1986,23,11,56,90,6
55,Napa,1987,11,3,4,18,3
55,Napa,1988,15,8,20,43,10
55,Napa,1989,23,7,9,39,5
55,Napa,1990,15,11,14,40,15
55,Napa,1991,20,12,58,90,16
55,Napa,1992,31,7,36,74,17
55,Napa,1993,27,13,50,90,34
55,Napa,1994,20,7,52,79,22
55,Napa,1995,15,7,20,42,14
55,Napa,1996,9,5,13,27,3
55,Napa,1997,24,6,11,41,4
55,Napa,1998,13,8,20,41,6
55,Napa,1999,13,10,14,37,3
55,Napa,2000,18,2,35,55,9
55,Napa,2001,5,15,31,51,0
55,Napa,2002,10,6,6,22,3
55,Napa,2003,10,7,5,22,3
55,Napa,2004,8,9,6,23,6
55,Napa,2005,16,5,2,23,4
55,Napa,2006,14,10,2,26,1
55,Napa,2007,7,6,6,19,3
55,Napa,2008,6,6,0,12,1
55,Napa,2009,6,6,1,13,1
55,Napa,2010,6,3,4,13,2
55,Napa,2011,5,5,5,15,1
55,Napa,2012,5,3,3,11,0
55,Napa,2013,8,5,8,21,3
55,Napa,2014,2,1,0,3,1
55,Napa,2015,5,1,3,9,1
55,Napa,2016,5,3,3,11,6
55,Napa,2017,2,1,3,6,3
55,Napa,2018,6,4,22,32,2
55,Napa,2019,13,7,30,50,10
57,Nevada,1985,8,6,15,29,2
57,Nevada,1986,8,2,49,59,4
57,Nevada,1987,3,3,1,7,4
57,Nevada,1988,2,3,9,14,1
57,Nevada,1989,3,0,2,5,2
57,Nevada,1990,1,3,1,5,2
57,Nevada,1991,7,3,1,11,1
57,Nevada,1992,8,2,2,12,6
57,Nevada,1993,2,3,0,5,1
57,Nevada,1994,1,2,0,3,1
57,Nevada,1995,4,1,2,7,1
57,Nevada,1996,3,2,3,8,2
57,Nevada,1997,3,0,4,7,3
57,Nevada,1998,3,1,3,7,1
57,Nevada,1999,10,2,0,12,4
57,Nevada,2000,5,2,1,8,1
57,Nevada,2001,7,2,0,9,3
57,Nevada,2002,1,5,2,8,4
57,Nevada,2003,3,6,7,16,7
57,Nevada,2004,3,2,5,10,3
57,Nevada,2005,4,0,6,10,2
57,Nevada,2006,3,3,5,11,6
57,Nevada,2007,4,1,3,8,0
57,Nevada,2008,1,0,1,2,1
57,Nevada,2009,8,3,0,11,4
57,Nevada,2010,5,2,0,7,1
57,Nevada,2011,1,2,4,7,5
57,Nevada,2012,9,1,4,14,7
57,Nevada,2013,3,0,6,9,5
57,Nevada,2014,4,1,4,9,1
57,Nevada,2015,6,1,11,18,12
57,Nevada,2016,4,2,7,13,8
57,Nevada,2017,5,1,4,10,0
57,Nevada,2018,1,0,3,4,3
57,Nevada,2019,1,0,3,4,3
59,Orange,1985,465,293,705,1463,83
59,Orange,1986,411,254,407,1072,86
59,Orange,1987,334,249,336,919,79
59,Orange,1988,384,234,523,1141,71
59,Orange,1989,385,316,583,1284,108
59,Orange,1990,405,274,647,1326,163
59,Orange,1991,411,308,752,1471,188
59,Orange,1992,398,264,668,1330,160
59,Orange,1993,308,241,713,1262,105
59,Orange,1994,264,172,545,981,111
59,Orange,1995,309,168,457,934,75
59,Orange,1996,324,157,493,974,102
59,Orange,1997,235,155,430,820,64
59,Orange,1998,251,147,434,832,76
59,Orange,1999,216,113,429,758,71
59,Orange,2000,259,166,270,695,69
59,Orange,2001,199,144,246,589,56
59,Orange,2002,191,132,323,646,126
59,Orange,2003,205,114,348,667,53
59,Orange,2004,175,117,310,602,104
59,Orange,2005,170,119,449,738,133
59,Orange,2006,149,109,435,693,79
59,Orange,2007,143,105,393,641,76
59,Orange,2008,152,96,340,588,47
59,Orange,2009,125,73,280,478,68
59,Orange,2010,106,63,260,429,73
59,Orange,2011,82,65,183,330,38
59,Orange,2012,99,51,148,298,58
59,Orange,2013,85,42,141,268,60
59,Orange,2014,76,46,99,221,45
59,Orange,2015,80,47,110,237,48
59,Orange,2016,87,53,129,269,80
59,Orange,2017,94,52,182,328,99
59,Orange,2018,111,58,131,300,105
59,Orange,2019,92,43,128,263,84
61,Placer,1985,12,9,79,100,3
61,Placer,1986,21,19,77,117,11
61,Placer,1987,12,6,21,39,12
61,Placer,1988,29,9,9,47,9
61,Placer,1989,21,4,8,33,5
61,Placer,1990,17,7,5,29,9
61,Placer,1991,17,11,8,36,5
61,Placer,1992,16,14,8,38,6
61,Placer,1993,24,26,17,67,15
61,Placer,1994,32,5,26,63,7
61,Placer,1995,30,4,15,49,7
61,Placer,1996,15,14,28,57,12
61,Placer,1997,18,3,27,48,11
61,Placer,1998,10,4,21,35,4
61,Placer,1999,16,7,27,50,8
61,Placer,2000,19,2,10,31,9
61,Placer,2001,13,6,22,41,8
61,Placer,2002,16,7,13,36,4
61,Placer,2003,22,8,16,46,15
61,Placer,2004,17,3,21,41,16
61,Placer,2005,24,5,17,46,6
61,Placer,2006,22,12,12,46,11
61,Placer,2007,25,6,19,50,17
61,Placer,2008,19,13,10,42,20
61,Placer,2009,21,7,14,42,8
61,Placer,2010,25,1,19,45,13
61,Placer,2011,18,1,13,32,9
61,Placer,2012,12,4,21,37,8
61,Placer,2013,19,5,22,46,12
61,Placer,2014,15,4,16,35,11
61,Placer,2015,11,0,13,24,8
61,Placer,2016,13,7,13,33,7
61,Placer,2017,33,3,17,53,12
61,Placer,2018,18,3,17,38,10
61,Placer,2019,28,3,10,41,13
63,Plumas,1985,1,0,0,1,0
63,Plumas,1986,6,1,0,7,2
63,Plumas,1987,2,1,0,3,0
63,Plumas,1988,8,1,0,9,6
63,Plumas,1989,3,1,0,4,2
63,Plumas,1990,1,0,0,1,0
63,Plumas,1991,3,1,1,5,1
63,Plumas,1992,6,1,0,7,2
63,Plumas,1993,1,1,1,3,2
63,Plumas,1994,2,3,2,7,1
63,Plumas,1995,5,0,0,5,2
63,Plumas,1996,1,1,1,3,1
63,Plumas,1997,7,0,3,10,4
63,Plumas,1998,1,0,0,1,0
63,Plumas,1999,1,1,4,6,3
63,Plumas,2000,5,1,3,9,5
63,Plumas,2001,3,1,2,6,4
63,Plumas,2002,2,2,1,5,1
63,Plumas,2003,0,1,1,2,1
63,Plumas,2004,0,1,0,1,1
63,Plumas,2005,0,0,0,0,0
63,Plumas,2006,1,1,1,3,3
63,Plumas,2007,0,0,4,4,0
63,Plumas,2008,0,0,0,0,0
63,Plumas,2009,1,1,0,2,0
63,Plumas,2010,1,0,0,1,0
63,Plumas,2011,2,0,5,7,6
63,Plumas,2012,0,0,0,0,0
63,Plumas,2013,2,0,0,2,0
63,Plumas,2014,0,1,0,1,0
63,Plumas,2015,0,0,0,0,0
63,Plumas,2016,0,0,1,1,0
63,Plumas,2017,1,1,4,6,2
63,Plumas,2018,0,1,2,3,2
63,Plumas,2019,1,1,1,3,1
65,Riverside,1985,208,166,430,804,94
65,Riverside,1986,238,195,360,793,115
65,Riverside,1987,168,141,362,671,74
65,Riverside,1988,177,159,471,807,63
65,Riverside,1989,167,170,518,855,81
65,Riverside,1990,208,138,318,664,82
65,Riverside,1991,230,152,325,707,94
65,Riverside,1992,227,141,539,907,173
65,Riverside,1993,191,157,638,986,196
65,Riverside,1994,144,106,492,742,174
65,Riverside,1995,157,125,434,716,124
65,Riverside,1996,141,115,394,650,123
65,Riverside,1997,104,87,309,500,93
65,Riverside,1998,105,76,260,441,89
65,Riverside,1999,90,57,242,389,88
65,Riverside,2000,209,70,178,457,145
65,Riverside,2001,144,146,220,510,48
65,Riverside,2002,178,139,183,500,80
65,Riverside,2003,143,133,203,479,73
65,Riverside,2004,112,135,236,483,64
65,Riverside,2005,128,130,193,451,48
65,Riverside,2006,98,121,170,389,50
65,Riverside,2007,93,96,133,322,31
65,Riverside,2008,96,110,137,343,39
65,Riverside,2009,84,87,112,283,24
65,Riverside,2010,65,73,108,246,25
65,Riverside,2011,55,38,93,186,28
65,Riverside,2012,70,80,91,241,30
65,Riverside,2013,54,48,111,213,23
65,Riverside,2014,79,50,126,255,31
65,Riverside,2015,50,61,123,234,31
65,Riverside,2016,52,48,109,209,34
65,Riverside,2017,76,57,96,229,45
65,Riverside,2018,82,41,121,244,42
65,Riverside,2019,86,51,139,276,62
67,Sacramento,1985,268,122,44,434,90
67,Sacramento,1986,243,213,47,503,75
67,Sacramento,1987,203,250,51,504,61
67,Sacramento,1988,183,171,29,383,66
67,Sacramento,1989,151,135,23,309,56
67,Sacramento,1990,128,141,17,286,45
67,Sacramento,1991,153,135,12,300,59
67,Sacramento,1992,200,115,44,359,78
67,Sacramento,1993,182,84,36,302,102
67,Sacramento,1994,157,73,28,258,79
67,Sacramento,1995,220,63,39,322,46
67,Sacramento,1996,180,82,51,313,40
67,Sacramento,1997,224,91,81,396,118
67,Sacramento,1998,250,101,57,408,97
67,Sacramento,1999,376,138,121,635,150
67,Sacramento,2000,290,238,129,657,113
67,Sacramento,2001,322,256,189,767,215
67,Sacramento,2002,249,205,118,572,113
67,Sacramento,2003,290,256,194,740,139
67,Sacramento,2004,255,243,180,678,129
67,Sacramento,2005,221,240,166,627,123
67,Sacramento,2006,219,192,167,578,124
67,Sacramento,2007,163,133,154,450,76
67,Sacramento,2008,184,104,177,465,91
67,Sacramento,2009,149,86,131,366,77
67,Sacramento,2010,173,72,156,401,76
67,Sacramento,2011,127,57,102,286,70
67,Sacramento,2012,135,48,61,244,62
67,Sacramento,2013,128,47,97,272,63
67,Sacramento,2014,136,35,95,266,58
67,Sacramento,2015,83,31,86,200,52
67,Sacramento,2016,126,49,106,281,70
67,Sacramento,2017,133,58,124,315,71
67,Sacramento,2018,108,51,102,261,83
67,Sacramento,2019,101,60,117,278,90
69,San Benito,1985,9,3,2,14,2
69,San Benito,1986,6,4,3,13,7
69,San Benito,1987,7,5,4,16,6
69,San Benito,1988,11,2,2,15,3
69,San Benito,1989,3,0,2,5,0
69,San Benito,1990,7,0,12,19,8
69,San Benito,1991,9,0,0,9,1
69,San Benito,1992,7,4,1,12,4
69,San Benito,1993,16,3,10,29,5
69,San Benito,1994,3,1,7,11,3
69,San Benito,1995,9,3,6,18,3
69,San Benito,1996,9,5,10,24,8
69,San Benito,1997,4,1,4,9,2
69,San Benito,1998,3,1,5,9,3
69,San Benito,1999,3,5,3,11,2
69,San Benito,2000,0,1,1,2,0
69,San Benito,2001,6,7,3,16,1
69,San Benito,2002,0,4,3,7,1
69,San Benito,2003,5,5,3,13,3
69,San Benito,2004,6,2,1,9,2
69,San Benito,2005,4,4,7,15,4
69,San Benito,2006,2,4,10,16,1
69,San Benito,2007,8,6,8,22,3
69,San Benito,2008,7,0,7,14,2
69,San Benito,2009,2,1,5,8,1
69,San Benito,2010,1,1,2,4,0
69,San Benito,2011,1,0,12,13,0
69,San Benito,2012,2,5,5,12,3
69,San Benito,2013,4,3,0,7,1
69,San Benito,2014,3,0,1,4,3
69,San Benito,2015,3,0,1,4,0
69,San Benito,2016,1,1,4,6,2
69,San Benito,2017,4,0,2,6,1
69,San Benito,2018,1,1,0,2,0
69,San Benito,2019,1,0,4,5,0
71,San Bernardino,1985,279,212,313,804,111
71,San Bernardino,1986,318,252,320,890,105
71,San Bernardino,1987,268,237,245,750,97
71,San Bernardino,1988,240,202,273,715,64
71,San Bernardino,1989,300,220,215,735,76
71,San Bernardino,1990,352,304,159,815,89
71,San Bernardino,1991,376,260,161,797,83
71,San Bernardino,1992,380,234,122,736,81
71,San Bernardino,1993,282,202,135,619,104
71,San Bernardino,1994,350,209,191,750,166
71,San Bernardino,1995,364,188,185,737,154
71,San Bernardino,1996,287,218,287,792,148
71,San Bernardino,1997,283,179,256,718,129
71,San Bernardino,1998,299,190,207,696,144
71,San Bernardino,1999,266,158,247,671,137
71,San Bernardino,2000,263,213,212,688,125
71,San Bernardino,2001,279,235,257,771,159
71,San Bernardino,2002,246,249,215,710,141
71,San Bernardino,2003,229,218,244,691,155
71,San Bernardino,2004,220,223,133,576,112
71,San Bernardino,2005,207,201,156,564,135
71,San Bernardino,2006,216,175,166,557,123
71,San Bernardino,2007,177,211,129,517,90
71,San Bernardino,2008,190,206,148,544,115
71,San Bernardino,2009,199,158,155,512,106
71,San Bernardino,2010,179,121,105,405,92
71,San Bernardino,2011,186,118,111,415,107
71,San Bernardino,2012,164,99,104,367,97
71,San Bernardino,2013,165,126,120,411,126
71,San Bernardino,2014,181,111,141,433,144
71,San Bernardino,2015,171,114,120,405,120
71,San Bernardino,2016,153,121,118,392,89
71,San Bernardino,2017,170,118,122,410,115
71,San Bernardino,2018,157,128,176,461,129
71,San Bernardino,2019,159,108,149,416,125
73,San Diego,1985,476,226,133,835,177
73,San Diego,1986,452,226,163,841,153
73,San Diego,1987,387,182,182,751,204
73,San Diego,1988,405,175,133,713,160
73,San Diego,1989,430,159,78,667,186
73,San Diego,1990,374,190,156,720,169
73,San Diego,1991,408,195,77,680,135
73,San Diego,1992,419,187,79,685,136
73,San Diego,1993,410,184,88,682,127
73,San Diego,1994,372,147,106,625,157
73,San Diego,1995,356,155,109,620,129
73,San Diego,1996,332,169,126,627,142
73,San Diego,1997,279,184,91,554,117
73,San Diego,1998,306,169,55,530,123
73,San Diego,1999,296,164,85,545,110
73,San Diego,2000,239,162,56,457,111
73,San Diego,2001,259,186,61,506,108
73,San Diego,2002,246,221,88,555,99
73,San Diego,2003,299,179,76,554,96
73,San Diego,2004,264,184,68,516,103
73,San Diego,2005,250,176,95,521,104
73,San Diego,2006,210,184,74,468,94
73,San Diego,2007,175,154,110,439,83
73,San Diego,2008,195,148,71,414,91
73,San Diego,2009,181,142,71,394,95
73,San Diego,2010,156,125,75,356,86
73,San Diego,2011,149,95,70,314,62
73,San Diego,2012,182,86,78,346,88
73,San Diego,2013,165,84,117,366,108
73,San Diego,2014,176,92,124,392,97
73,San Diego,2015,140,79,122,341,105
73,San Diego,2016,194,84,142,420,126
73,San Diego,2017,151,69,127,347,127
73,San Diego,2018,121,98,143,362,137
73,San Diego,2019,90,52,138,280,117
75,San Francisco,1985,258,109,38,405,70
75,San Francisco,1986,268,144,18,430,47
75,San Francisco,1987,241,134,15,390,60
75,San Francisco,1988,232,134,23,389,40
75,San Francisco,1989,187,180,13,380,40
75,San Francisco,1990,210,196,23,429,47
75,San Francisco,1991,196,215,21,432,37
75,San Francisco,1992,209,257,7,473,39
75,San Francisco,1993,215,267,20,502,28
75,San Francisco,1994,211,220,19,450,45
75,San Francisco,1995,220,197,38,455,42
75,San Francisco,1996,200,210,54,464,55
75,San Francisco,1997,151,216,65,432,44
75,San Francisco,1998,149,185,21,355,21
75,San Francisco,1999,127,140,9,276,21
75,San Francisco,2000,157,146,7,310,10
75,San Francisco,2001,116,131,8,255,24
75,San Francisco,2002,96,131,0,227,17
75,San Francisco,2003,123,137,0,260,29
75,San Francisco,2004,100,143,17,260,28
75,San Francisco,2005,74,93,22,189,16
75,San Francisco,2006,93,100,35,228,28
75,San Francisco,2007,91,102,41,234,32
75,San Francisco,2008,93,95,50,238,21
75,San Francisco,2009,48,97,53,198,20
75,San Francisco,2010,53,77,27,157,34
75,San Francisco,2011,63,63,37,163,27
75,San Francisco,2012,87,77,47,211,41
75,San Francisco,2013,97,65,65,227,54
75,San Francisco,2014,69,83,90,242,51
75,San Francisco,2015,57,78,137,272,54
75,San Francisco,2016,71,74,111,256,55
75,San Francisco,2017,74,95,134,303,57
75,San Francisco,2018,101,70,117,288,64
75,San Francisco,2019,86,78,113,277,69
77,San Joaquin,1985,118,90,30,238,29
77,San Joaquin,1986,111,125,21,257,36
77,San Joaquin,1987,93,98,26,217,40
77,San Joaquin,1988,79,90,11,180,20
77,San Joaquin,1989,92,156,26,274,28
77,San Joaquin,1990,78,145,36,259,16
77,San Joaquin,1991,155,127,41,323,39
77,San Joaquin,1992,162,109,60,331,42
77,San Joaquin,1993,95,139,35,269,28
77,San Joaquin,1994,134,122,65,321,25
77,San Joaquin,1995,106,101,40,247,25
77,San Joaquin,1996,105,90,58,253,31
77,San Joaquin,1997,105,113,110,328,40
77,San Joaquin,1998,113,72,50,235,35
77,San Joaquin,1999,126,89,59,274,41
77,San Joaquin,2000,132,91,62,285,48
77,San Joaquin,2001,126,93,57,276,36
77,San Joaquin,2002,108,24,58,190,39
77,San Joaquin,2003,84,71,58,213,41
77,San Joaquin,2004,64,60,61,185,38
77,San Joaquin,2005,60,49,49,158,39
77,San Joaquin,2006,54,43,50,147,30
77,San Joaquin,2007,49,31,69,149,33
77,San Joaquin,2008,66,35,65,166,31
77,San Joaquin,2009,44,36,41,121,23
77,San Joaquin,2010,69,29,35,133,23
77,San Joaquin,2011,87,29,43,159,28
77,San Joaquin,2012,76,31,51,158,28
77,San Joaquin,2013,71,43,43,157,25
77,San Joaquin,2014,64,23,59,146,30
77,San Joaquin,2015,87,40,67,194,42
77,San Joaquin,2016,68,19,45,132,23
77,San Joaquin,2017,133,44,93,270,47
77,San Joaquin,2018,92,73,94,259,36
77,San Joaquin,2019,92,29,82,203,47
79,San Luis Obispo,1985,35,12,14,61,26
79,San Luis Obispo,1986,40,14,18,72,16
79,San Luis Obispo,1987,20,11,8,39,12
79,San Luis Obispo,1988,19,8,8,35,6
79,San Luis Obispo,1989,33,11,12,56,6
79,San Luis Obispo,1990,28,9,11,48,8
79,San Luis Obispo,1991,32,14,31,77,7
79,San Luis Obispo,1992,24,12,29,65,32
79,San Luis Obispo,1993,25,12,46,83,15
79,San Luis Obispo,1994,34,10,83,127,18
79,San Luis Obispo,1995,38,12,112,162,19
79,San Luis Obispo,1996,44,6,72,122,28
79,San Luis Obispo,1997,31,14,50,95,15
79,San Luis Obispo,1998,28,7,57,92,9
79,San Luis Obispo,1999,34,13,108,155,10
79,San Luis Obispo,2000,24,7,93,124,12
79,San Luis Obispo,2001,25,8,101,134,9
79,San Luis Obispo,2002,14,5,49,68,7
79,San Luis Obispo,2003,30,13,47,90,12
79,San Luis Obispo,2004,22,6,52,80,17
79,San Luis Obispo,2005,9,6,47,62,2
79,San Luis Obispo,2006,14,10,59,83,6
79,San Luis Obispo,2007,10,17,57,84,11
79,San Luis Obispo,2008,27,5,43,75,7
79,San Luis Obispo,2009,16,12,60,88,6
79,San Luis Obispo,2010,5,3,43,51,4
79,San Luis Obispo,2011,9,4,39,52,4
79,San Luis Obispo,2012,12,11,64,87,7
79,San Luis Obispo,2013,10,5,46,61,2
79,San Luis Obispo,2014,2,4,28,34,4
79,San Luis Obispo,2015,6,3,54,63,2
79,San Luis Obispo,2016,13,14,32,59,13
79,San Luis Obispo,2017,7,5,24,36,6
79,San Luis Obispo,2018,5,5,34,44,10
79,San Luis Obispo,2019,13,4,27,44,7
81,San Mateo,1985,105,54,66,225,35
81,San Mateo,1986,92,61,49,202,38
81,San Mateo,1987,64,56,49,169,21
81,San Mateo,1988,66,50,43,159,29
81,San Mateo,1989,67,33,28,128,18
81,San Mateo,1990,71,34,32,137,22
81,San Mateo,1991,81,48,28,157,24
81,San Mateo,1992,67,38,34,139,27
81,San Mateo,1993,50,57,32,139,30
81,San Mateo,1994,58,41,35,134,18
81,San Mateo,1995,52,61,27,140,28
81,San Mateo,1996,47,67,26,140,12
81,San Mateo,1997,39,55,28,122,28
81,San Mateo,1998,60,57,26,143,19
81,San Mateo,1999,38,39,34,111,14
81,San Mateo,2000,38,32,38,108,18
81,San Mateo,2001,41,42,50,133,20
81,San Mateo,2002,45,30,34,109,19
81,San Mateo,2003,56,39,37,132,13
81,San Mateo,2004,65,37,40,142,18
81,San Mateo,2005,87,25,39,151,25
81,San Mateo,2006,59,33,57,149,23
81,San Mateo,2007,55,29,65,149,16
81,San Mateo,2008,52,21,45,118,18
81,San Mateo,2009,63,24,38,125,19
81,San Mateo,2010,55,21,20,96,19
81,San Mateo,2011,49,19,20,88,11
81,San Mateo,2012,44,19,21,84,14
81,San Mateo,2013,58,13,38,109,13
81,San Mateo,2014,46,7,26,79,19
81,San Mateo,2015,46,5,27,78,12
81,San Mateo,2016,47,4,27,78,11
81,San Mateo,2017,58,3,31,92,23
81,San Mateo,2018,48,6,18,72,16
81,San Mateo,2019,40,3,27,70,26
83,Santa Barbara,1985,53,27,65,145,31
83,Santa Barbara,1986,41,20,62,123,65
83,Santa Barbara,1987,39,17,57,113,74
83,Santa Barbara,1988,44,23,37,104,53
83,Santa Barbara,1989,42,16,60,118,51
83,Santa Barbara,1990,32,8,44,84,35
83,Santa Barbara,1991,32,18,23,73,15
83,Santa Barbara,1992,36,15,42,93,26
83,Santa Barbara,1993,42,18,33,93,34
83,Santa Barbara,1994,46,15,41,102,35
83,Santa Barbara,1995,61,14,41,116,21
83,Santa Barbara,1996,36,8,33,77,27
83,Santa Barbara,1997,23,23,34,80,18
83,Santa Barbara,1998,34,16,26,76,17
83,Santa Barbara,1999,29,18,52,99,30
83,Santa Barbara,2000,32,21,72,125,39
83,Santa Barbara,2001,16,16,55,87,24
83,Santa Barbara,2002,35,23,46,104,20
83,Santa Barbara,2003,42,14,47,103,19
83,Santa Barbara,2004,45,30,58,133,15
83,Santa Barbara,2005,27,18,56,101,15
83,Santa Barbara,2006,32,12,33,77,21
83,Santa Barbara,2007,21,10,41,72,8
83,Santa Barbara,2008,31,17,37,85,10
83,Santa Barbara,2009,21,18,30,69,8
83,Santa Barbara,2010,15,13,16,44,5
83,Santa Barbara,2011,26,10,37,73,23
83,Santa Barbara,2012,11,20,23,54,18
83,Santa Barbara,2013,27,12,21,60,21
83,Santa Barbara,2014,21,11,17,49,18
83,Santa Barbara,2015,22,6,24,52,17
83,Santa Barbara,2016,13,9,27,49,16
83,Santa Barbara,2017,30,7,17,54,17
83,Santa Barbara,2018,37,7,15,59,14
83,Santa Barbara,2019,26,10,18,54,16
85,Santa Clara,1985,375,135,326,836,114
85,Santa Clara,1986,286,156,214,656,101
85,Santa Clara,1987,239,245,137,621,84
85,Santa Clara,1988,224,243,160,627,119
85,Santa Clara,1989,304,218,183,705,87
85,Santa Clara,1990,312,219,221,752,147
85,Santa Clara,1991,226,201,176,603,100
85,Santa Clara,1992,226,204,132,562,94
85,Santa Clara,1993,293,166,128,587,112
85,Santa Clara,1994,314,286,118,718,61
85,Santa Clara,1995,277,351,106,734,75
85,Santa Clara,1996,329,405,133,867,67
85,Santa Clara,1997,120,58,116,294,77
85,Santa Clara,1998,229,46,196,471,48
85,Santa Clara,1999,205,92,178,475,65
85,Santa Clara,2000,248,106,207,561,56
85,Santa Clara,2001,267,127,250,644,79
85,Santa Clara,2002,149,111,168,428,53
85,Santa Clara,2003,185,82,137,404,48
85,Santa Clara,2004,225,84,115,424,69
85,Santa Clara,2005,157,109,276,542,75
85,Santa Clara,2006,222,94,356,672,82
85,Santa Clara,2007,171,65,340,576,97
85,Santa Clara,2008,174,106,218,498,98
85,Santa Clara,2009,149,71,183,403,58
85,Santa Clara,2010,148,59,177,384,54
85,Santa Clara,2011,125,52,107,284,36
85,Santa Clara,2012,126,57,129,312,31
85,Santa Clara,2013,115,53,73,241,24
85,Santa Clara,2014,100,49,81,230,57
85,Santa Clara,2015,72,36,85,193,26
85,Santa Clara,2016,108,51,89,248,41
85,Santa Clara,2017,117,43,106,266,50
85,Santa Clara,2018,80,40,88,208,41
85,Santa Clara,2019,110,35,108,253,71
87,Santa Cruz,1985,31,22,23,76,11
87,Santa Cruz,1986,38,45,36,119,13
87,Santa Cruz,1987,38,36,31,105,20
87,Santa Cruz,1988,24,25,16,65,12
87,Santa Cruz,1989,25,12,13,50,14
87,Santa Cruz,1990,32,13,30,75,10
87,Santa Cruz,1991,23,18,27,68,23
87,Santa Cruz,1992,23,29,23,75,16
87,Santa Cruz,1993,37,18,35,90,24
87,Santa Cruz,1994,34,22,34,90,21
87,Santa Cruz,1995,45,23,29,97,28
87,Santa Cruz,1996,37,24,14,75,13
87,Santa Cruz,1997,41,28,26,95,28
87,Santa Cruz,1998,27,19,20,66,9
87,Santa Cruz,1999,33,17,34,84,21
87,Santa Cruz,2000,15,12,17,44,8
87,Santa Cruz,2001,34,13,11,58,5
87,Santa Cruz,2002,41,19,12,72,8
87,Santa Cruz,2003,31,13,10,54,3
87,Santa Cruz,2004,22,20,17,59,4
87,Santa Cruz,2005,18,19,12,49,2
87,Santa Cruz,2006,37,23,25,85,9
87,Santa Cruz,2007,44,16,29,89,12
87,Santa Cruz,2008,39,16,17,72,13
87,Santa Cruz,2009,37,19,11,67,3
87,Santa Cruz,2010,35,20,7,62,4
87,Santa Cruz,2011,19,13,7,39,1
87,Santa Cruz,2012,28,9,6,43,2
87,Santa Cruz,2013,30,16,14,60,4
87,Santa Cruz,2014,21,16,15,52,5
87,Santa Cruz,2015,25,6,18,49,5
87,Santa Cruz,2016,19,12,7,38,9
87,Santa Cruz,2017,37,7,25,69,6
87,Santa Cruz,2018,27,7,50,84,11
87,Santa Cruz,2019,16,5,33,54,7
89,Shasta,1985,13,12,10,35,8
89,Shasta,1986,18,10,3,31,8
89,Shasta,1987,17,6,2,25,8
89,Shasta,1988,15,5,4,24,15
89,Shasta,1989,9,5,4,18,9
89,Shasta,1990,16,7,6,29,10
89,Shasta,1991,17,9,18,44,18
89,Shasta,1992,14,9,18,41,24
89,Shasta,1993,23,14,63,100,16
89,Shasta,1994,25,21,61,107,24
89,Shasta,1995,21,8,57,86,15
89,Shasta,1996,32,8,50,90,13
89,Shasta,1997,33,11,53,97,13
89,Shasta,1998,15,20,65,100,14
89,Shasta,1999,18,8,132,158,13
89,Shasta,2000,17,9,55,81,13
89,Shasta,2001,13,18,62,93,16
89,Shasta,2002,15,11,48,74,10
89,Shasta,2003,16,8,34,58,8
89,Shasta,2004,24,9,44,77,18
89,Shasta,2005,15,17,24,56,5
89,Shasta,2006,20,8,17,45,15
89,Shasta,2007,13,9,21,43,4
89,Shasta,2008,13,10,11,34,9
89,Shasta,2009,14,4,9,27,6
89,Shasta,2010,14,1,8,23,11
89,Shasta,2011,5,2,2,9,2
89,Shasta,2012,4,1,30,35,7
89,Shasta,2013,7,4,62,73,7
89,Shasta,2014,9,0,29,38,5
89,Shasta,2015,4,2,30,36,11
89,Shasta,2016,13,1,23,37,10
89,Shasta,2017,11,0,50,61,12
89,Shasta,2018,9,0,44,53,13
89,Shasta,2019,5,2,7,14,11
91,Sierra,1985,2,0,0,2,0
91,Sierra,1986,2,0,0,2,0
91,Sierra,1987,1,1,0,2,1
91,Sierra,1988,0,1,0,1,0
91,Sierra,1989,0,0,0,0,0
91,Sierra,1990,0,0,0,0,0
91,Sierra,1991,0,1,0,1,0
91,Sierra,1992,0,1,0,1,1
91,Sierra,1993,0,0,0,0,0
91,Sierra,1994,0,0,0,0,0
91,Sierra,1995,0,0,0,0,0
91,Sierra,1996,1,0,0,1,0
91,Sierra,1997,0,0,0,0,0
91,Sierra,1998,0,0,0,0,0
91,Sierra,1999,0,0,0,0,0
91,Sierra,2000,1,0,0,1,0
91,Sierra,2001,2,0,5,7,6
91,Sierra,2002,0,0,0,0,0
91,Sierra,2003,2,0,1,3,1
91,Sierra,2004,0,0,0,0,0
91,Sierra,2005,0,0,1,1,0
91,Sierra,2006,0,0,0,0,0
91,Sierra,2007,0,0,0,0,0
91,Sierra,2008,0,1,0,1,1
91,Sierra,2009,1,0,0,1,0
91,Sierra,2010,0,0,0,0,0
91,Sierra,2011,1,1,0,2,1
91,Sierra,2012,0,0,1,1,1
91,Sierra,2013,0,0,0,0,0
91,Sierra,2014,0,0,0,0,0
91,Sierra,2015,0,0,0,0,0
91,Sierra,2016,1,0,0,1,0
91,Sierra,2017,0,0,0,0,0
91,Sierra,2018,0,0,0,0,0
91,Sierra,2019,0,0,0,0,0
93,Siskiyou,1985,9,4,2,15,6
93,Siskiyou,1986,8,1,3,12,2
93,Siskiyou,1987,6,2,10,18,11
93,Siskiyou,1988,6,1,1,8,3
93,Siskiyou,1989,4,2,1,7,1
93,Siskiyou,1990,5,1,0,6,1
93,Siskiyou,1991,4,3,0,7,3
93,Siskiyou,1992,4,2,7,13,7
93,Siskiyou,1993,5,2,1,8,2
93,Siskiyou,1994,5,0,0,5,0
93,Siskiyou,1995,6,0,1,7,5
93,Siskiyou,1996,10,2,3,15,2
93,Siskiyou,1997,6,0,0,6,1
93,Siskiyou,1998,7,4,1,12,3
93,Siskiyou,1999,3,1,1,5,1
93,Siskiyou,2000,4,2,0,6,2
93,Siskiyou,2001,6,3,3,12,8
93,Siskiyou,2002,6,4,4,14,5
93,Siskiyou,2003,2,2,0,4,0
93,Siskiyou,2004,9,6,0,15,4
93,Siskiyou,2005,3,2,0,5,2
93,Siskiyou,2006,9,5,1,15,4
93,Siskiyou,2007,5,8,1,14,10
93,Siskiyou,2008,12,4,5,21,10
93,Siskiyou,2009,3,0,0,3,1
93,Siskiyou,2010,5,4,1,10,2
93,Siskiyou,2011,4,1,0,5,2
93,Siskiyou,2012,2,0,0,2,2
93,Siskiyou,2013,1,1,2,4,3
93,Siskiyou,2014,4,0,2,6,2
93,Siskiyou,2015,1,0,2,3,0
93,Siskiyou,2016,2,1,2,5,2
93,Siskiyou,2017,1,1,2,4,2
93,Siskiyou,2018,1,0,1,2,2
93,Siskiyou,2019,0,0,1,1,0
95,Solano,1985,58,26,77,161,28
95,Solano,1986,50,29,62,141,35
95,Solano,1987,66,26,51,143,44
95,Solano,1988,52,42,37,131,42
95,Solano,1989,72,36,30,138,27
95,Solano,1990,77,51,35,163,22
95,Solano,1991,79,49,42,170,19
95,Solano,1992,44,48,45,137,25
95,Solano,1993,78,61,57,196,32
95,Solano,1994,63,34,50,147,40
95,Solano,1995,62,42,84,188,39
95,Solano,1996,71,63,82,216,45
95,Solano,1997,73,38,57,168,37
95,Solano,1998,72,52,51,175,21
95,Solano,1999,44,60,50,154,27
95,Solano,2000,41,72,74,187,24
95,Solano,2001,50,115,75,240,40
95,Solano,2002,58,97,42,197,35
95,Solano,2003,63,79,53,195,22
95,Solano,2004,41,48,36,125,18
95,Solano,2005,45,60,47,152,12
95,Solano,2006,70,90,48,208,28
95,Solano,2007,64,70,75,209,22
95,Solano,2008,50,50,35,135,17
95,Solano,2009,43,38,35,116,22
95,Solano,2010,23,30,45,98,9
95,Solano,2011,30,44,33,107,12
95,Solano,2012,64,38,16,118,13
95,Solano,2013,54,32,29,115,16
95,Solano,2014,65,10,12,87,13
95,Solano,2015,70,9,28,107,18
95,Solano,2016,95,7,19,121,23
95,Solano,2017,99,11,30,140,39
95,Solano,2018,78,14,15,107,18
95,Solano,2019,83,1,22,106,29
97,Sonoma,1985,71,36,59,166,27
97,Sonoma,1986,74,37,33,144,17
97,Sonoma,1987,84,52,49,185,32
97,Sonoma,1988,85,41,32,158,24
97,Sonoma,1989,74,45,39,158,23
97,Sonoma,1990,53,33,59,145,28
97,Sonoma,1991,48,24,53,125,21
97,Sonoma,1992,52,30,61,143,19
97,Sonoma,1993,65,33,65,163,29
97,Sonoma,1994,67,33,69,169,44
97,Sonoma,1995,74,35,77,186,33
97,Sonoma,1996,69,26,72,167,21
97,Sonoma,1997,58,23,72,153,22
97,Sonoma,1998,54,26,65,145,16
97,Sonoma,1999,41,21,54,116,19
97,Sonoma,2000,62,25,68,155,26
97,Sonoma,2001,56,27,75,158,16
97,Sonoma,2002,28,35,53,116,17
97,Sonoma,2003,34,17,36,87,7
97,Sonoma,2004,30,24,30,84,13
97,Sonoma,2005,26,28,32,86,6
97,Sonoma,2006,53,10,40,103,12
97,Sonoma,2007,35,17,31,83,7
97,Sonoma,2008,33,14,33,80,11
97,Sonoma,2009,27,23,35,85,10
97,Sonoma,2010,24,12,18,54,13
97,Sonoma,2011,25,11,24,60,6
97,Sonoma,2012,23,18,21,62,17
97,Sonoma,2013,25,10,34,69,18
97,Sonoma,2014,20,8,40,68,10
97,Sonoma,2015,25,9,53,87,32
97,Sonoma,2016,23,8,23,54,20
97,Sonoma,2017,23,6,35,64,20
97,Sonoma,2018,15,9,28,52,19
97,Sonoma,2019,30,6,36,72,27
99,Stanislaus,1985,109,62,107,278,65
99,Stanislaus,1986,121,104,115,340,73
99,Stanislaus,1987,102,75,109,286,29
99,Stanislaus,1988,129,81,109,319,65
99,Stanislaus,1989,115,88,107,310,50
99,Stanislaus,1990,109,99,125,333,42
99,Stanislaus,1991,99,123,130,352,91
99,Stanislaus,1992,133,137,356,626,85
99,Stanislaus,1993,154,97,308,559,79
99,Stanislaus,1994,135,109,332,576,85
99,Stanislaus,1995,133,130,265,528,102
99,Stanislaus,1996,145,115,244,504,120
99,Stanislaus,1997,144,157,227,528,60
99,Stanislaus,1998,110,153,104,367,82
99,Stanislaus,1999,111,158,210,479,57
99,Stanislaus,2000,135,174,225,534,72
99,Stanislaus,2001,152,248,197,597,78
99,Stanislaus,2002,106,292,75,473,51
99,Stanislaus,2003,96,314,93,503,68
99,Stanislaus,2004,73,373,84,530,59
99,Stanislaus,2005,99,292,59,450,60
99,Stanislaus,2006,95,224,81,400,42
99,Stanislaus,2007,115,236,98,449,42
99,Stanislaus,2008,81,189,84,354,43
99,Stanislaus,2009,111,183,79,373,47
99,Stanislaus,2010,93,121,55,269,24
99,Stanislaus,2011,67,57,33,157,23
99,Stanislaus,2012,42,36,39,117,25
99,Stanislaus,2013,43,34,62,139,32
99,Stanislaus,2014,20,27,71,118,36
99,Stanislaus,2015,22,31,73,126,27
99,Stanislaus,2016,26,34,51,111,31
99,Stanislaus,2017,35,35,57,127,27
99,Stanislaus,2018,58,33,59,150,29
99,Stanislaus,2019,86,34,49,169,34
101,Sutter,1985,4,3,0,7,2
101,Sutter,1986,9,7,2,18,2
101,Sutter,1987,5,6,1,12,3
101,Sutter,1988,2,6,1,9,3
101,Sutter,1989,2,3,1,6,1
101,Sutter,1990,3,6,4,13,2
101,Sutter,1991,7,1,2,10,4
101,Sutter,1992,3,4,1,8,1
101,Sutter,1993,5,3,3,11,1
101,Sutter,1994,11,4,2,17,6
101,Sutter,1995,10,2,1,13,5
101,Sutter,1996,4,5,6,15,5
101,Sutter,1997,3,4,6,13,2
101,Sutter,1998,4,4,4,12,4
101,Sutter,1999,4,4,1,9,1
101,Sutter,2000,8,3,2,13,4
101,Sutter,2001,7,4,2,13,0
101,Sutter,2002,10,12,4,26,4
101,Sutter,2003,7,6,3,16,1
101,Sutter,2004,16,8,12,36,9
101,Sutter,2005,10,8,4,22,3
101,Sutter,2006,7,13,11,31,5
101,Sutter,2007,10,6,6,22,5
101,Sutter,2008,11,5,2,18,4
101,Sutter,2009,7,2,2,11,2
101,Sutter,2010,4,4,4,12,2
101,Sutter,2011,5,5,5,15,1
101,Sutter,2012,7,2,6,15,1
101,Sutter,2013,7,7,4,18,4
101,Sutter,2014,10,10,4,24,6
101,Sutter,2015,9,2,7,18,5
101,Sutter,2016,6,2,1,9,5
101,Sutter,2017,7,3,7,17,8
101,Sutter,2018,5,6,1,12,5
101,Sutter,2019,6,0,2,8,6
103,Tehama,1985,7,6,11,24,6
103,Tehama,1986,12,3,17,32,1
103,Tehama,1987,2,4,21,27,9
103,Tehama,1988,5,5,15,25,4
103,Tehama,1989,13,9,20,42,3
103,Tehama,1990,2,9,13,24,4
103,Tehama,1991,4,5,20,29,0
103,Tehama,1992,9,2,30,41,3
103,Tehama,1993,11,5,20,36,11
103,Tehama,1994,10,6,29,45,2
103,Tehama,1995,25,8,65,98,22
103,Tehama,1996,9,7,34,50,6
103,Tehama,1997,11,8,32,51,8
103,Tehama,1998,5,6,15,26,3
103,Tehama,1999,5,4,16,25,1
103,Tehama,2000,4,8,9,21,4
103,Tehama,2001,5,3,18,26,6
103,Tehama,2002,7,8,11,26,2
103,Tehama,2003,15,10,17,42,9
103,Tehama,2004,5,4,16,25,8
103,Tehama,2005,6,12,14,32,3
103,Tehama,2006,10,12,20,42,9
103,Tehama,2007,8,8,14,30,2
103,Tehama,2008,8,7,7,22,1
103,Tehama,2009,9,15,9,33,5
103,Tehama,2010,7,5,3,15,1
103,Tehama,2011,4,0,6,10,3
103,Tehama,2012,4,0,1,5,3
103,Tehama,2013,4,3,12,19,5
103,Tehama,2014,5,0,2,7,3
103,Tehama,2015,12,4,7,23,12
103,Tehama,2016,8,1,4,13,8
103,Tehama,2017,8,0,4,12,6
103,Tehama,2018,13,0,8,21,14
103,Tehama,2019,16,0,6,22,10
105,Trinity,1985,0,0,0,0,0
105,Trinity,1986,2,0,1,3,2
105,Trinity,1987,0,0,0,0,0
105,Trinity,1988,5,3,0,8,1
105,Trinity,1989,3,2,0,5,1
105,Trinity,1990,3,0,0,3,1
105,Trinity,1991,2,0,0,2,1
105,Trinity,1992,0,1,0,1,0
105,Trinity,1993,3,0,1,4,1
105,Trinity,1994,1,0,0,1,0
105,Trinity,1995,1,0,0,1,0
105,Trinity,1996,1,0,0,1,0
105,Trinity,1997,2,0,0,2,0
105,Trinity,1998,0,0,1,1,1
105,Trinity,1999,0,2,3,5,2
105,Trinity,2000,2,2,0,4,1
105,Trinity,2001,5,2,7,14,2
105,Trinity,2002,2,2,2,6,0
105,Trinity,2003,0,0,0,0,0
105,Trinity,2004,0,0,0,0,0
105,Trinity,2005,0,0,0,0,0
105,Trinity,2006,1,0,1,2,1
105,Trinity,2007,0,0,0,0,0
105,Trinity,2008,0,0,0,0,0
105,Trinity,2009,0,0,0,0,0
105,Trinity,2010,0,0,0,0,0
105,Trinity,2011,0,0,0,0,0
105,Trinity,2012,0,0,0,0,0
105,Trinity,2013,0,0,0,0,0
105,Trinity,2014,2,0,0,2,2
105,Trinity,2015,0,0,0,0,0
105,Trinity,2016,0,0,0,0,0
105,Trinity,2017,1,0,0,1,0
105,Trinity,2018,5,0,1,6,2
105,Trinity,2019,1,1,0,2,0
107,Tulare,1985,105,62,192,359,34
107,Tulare,1986,69,58,214,341,25
107,Tulare,1987,77,81,232,390,29
107,Tulare,1988,66,56,188,310,32
107,Tulare,1989,72,69,298,439,29
107,Tulare,1990,63,81,270,414,27
107,Tulare,1991,66,98,150,314,40
107,Tulare,1992,63,121,255,439,31
107,Tulare,1993,75,115,371,561,87
107,Tulare,1994,68,164,313,545,29
107,Tulare,1995,68,155,306,529,23
107,Tulare,1996,55,186,395,636,27
107,Tulare,1997,74,248,324,646,28
107,Tulare,1998,56,233,322,611,30
107,Tulare,1999,70,197,353,620,37
107,Tulare,2000,55,209,345,609,21
107,Tulare,2001,64,231,352,647,11
107,Tulare,2002,67,287,353,707,19
107,Tulare,2003,73,300,304,677,14
107,Tulare,2004,79,301,368,748,19
107,Tulare,2005,92,278,273,643,22
107,Tulare,2006,98,301,330,729,25
107,Tulare,2007,93,166,80,339,18
107,Tulare,2008,38,26,81,145,14
107,Tulare,2009,33,21,37,91,6
107,Tulare,2010,10,9,44,63,7
107,Tulare,2011,14,9,44,67,7
107,Tulare,2012,11,10,18,39,9
107,Tulare,2013,10,4,30,44,11
107,Tulare,2014,9,14,14,37,10
107,Tulare,2015,13,8,12,33,15
107,Tulare,2016,15,4,9,28,6
107,Tulare,2017,24,25,23,72,22
107,Tulare,2018,31,67,16,114,27
107,Tulare,2019,23,38,26,87,23
109,Tuolumne,1985,19,4,0,23,1
109,Tuolumne,1986,12,8,19,39,2
109,Tuolumne,1987,24,8,2,34,2
109,Tuolumne,1988,5,5,1,11,2
109,Tuolumne,1989,9,1,3,13,1
109,Tuolumne,1990,9,4,2,15,2
109,Tuolumne,1991,6,3,4,13,4
109,Tuolumne,1992,8,6,1,15,1
109,Tuolumne,1993,7,0,0,7,0
109,Tuolumne,1994,1,0,1,2,0
109,Tuolumne,1995,5,4,0,9,0
109,Tuolumne,1996,8,4,0,12,0
109,Tuolumne,1997,17,4,4,25,9
109,Tuolumne,1998,6,3,1,10,1
109,Tuolumne,1999,7,4,1,12,1
109,Tuolumne,2000,5,2,3,10,0
109,Tuolumne,2001,10,4,1,15,3
109,Tuolumne,2002,16,6,3,25,2
109,Tuolumne,2003,5,4,6,15,2
109,Tuolumne,2004,12,4,6,22,6
109,Tuolumne,2005,7,5,6,18,4
109,Tuolumne,2006,4,1,3,8,1
109,Tuolumne,2007,4,3,1,8,1
109,Tuolumne,2008,7,3,4,14,1
109,Tuolumne,2009,3,6,2,11,4
109,Tuolumne,2010,6,0,3,9,5
109,Tuolumne,2011,10,6,4,20,6
109,Tuolumne,2012,18,2,5,25,9
109,Tuolumne,2013,10,0,5,15,6
109,Tuolumne,2014,7,0,3,10,6
109,Tuolumne,2015,5,0,1,6,3
109,Tuolumne,2016,8,1,3,12,5
109,Tuolumne,2017,10,0,3,13,6
109,Tuolumne,2018,4,0,4,8,4
109,Tuolumne,2019,6,0,4,10,6
111,Ventura,1985,103,76,60,239,46
111,Ventura,1986,76,66,52,194,36
111,Ventura,1987,93,85,39,217,42
111,Ventura,1988,95,63,57,215,40
111,Ventura,1989,99,76,75,250,45
111,Ventura,1990,99,62,75,236,55
111,Ventura,1991,106,76,83,265,47
111,Ventura,1992,102,96,84,282,36
111,Ventura,1993,97,73,115,285,47
111,Ventura,1994,89,46,82,217,45
111,Ventura,1995,69,43,55,167,39
111,Ventura,1996,74,60,113,247,40
111,Ventura,1997,57,48,84,189,35
111,Ventura,1998,38,29,56,123,20
111,Ventura,1999,69,45,78,192,32
111,Ventura,2000,40,55,56,151,20
111,Ventura,2001,40,37,78,155,24
111,Ventura,2002,33,57,67,157,26
111,Ventura,2003,48,58,91,197,24
111,Ventura,2004,56,52,71,179,29
111,Ventura,2005,61,56,53,170,22
111,Ventura,2006,54,52,64,170,27
111,Ventura,2007,66,43,52,161,23
111,Ventura,2008,57,58,52,167,26
111,Ventura,2009,39,32,42,113,22
111,Ventura,2010,36,26,37,99,26
111,Ventura,2011,41,23,47,111,28
111,Ventura,2012,45,21,62,128,16
111,Ventura,2013,33,42,55,130,17
111,Ventura,2014,33,24,27,84,17
111,Ventura,2015,25,28,42,95,25
111,Ventura,2016,34,32,47,113,21
111,Ventura,2017,34,26,50,110,31
111,Ventura,2018,53,24,26,103,33
111,Ventura,2019,37,27,27,91,29
113,Yolo,1985,41,39,16,96,11
113,Yolo,1986,45,29,16,90,8
113,Yolo,1987,33,26,17,76,12
113,Yolo,1988,35,23,26,84,10
113,Yolo,1989,22,30,14,66,7
113,Yolo,1990,30,24,23,77,11
113,Yolo,1991,39,37,20,96,5
113,Yolo,1992,38,29,36,103,10
113,Yolo,1993,33,36,37,106,7
113,Yolo,1994,23,32,33,88,10
113,Yolo,1995,27,13,15,55,8
113,Yolo,1996,48,11,30,89,17
113,Yolo,1997,41,7,21,69,9
113,Yolo,1998,13,6,28,47,7
113,Yolo,1999,24,29,38,91,3
113,Yolo,2000,29,21,40,90,14
113,Yolo,2001,44,17,55,116,13
113,Yolo,2002,56,20,63,139,21
113,Yolo,2003,83,30,66,179,38
113,Yolo,2004,67,36,35,138,17
113,Yolo,2005,52,12,19,83,7
113,Yolo,2006,57,22,57,136,40
113,Yolo,2007,39,22,27,88,13
113,Yolo,2008,30,11,34,75,11
113,Yolo,2009,33,13,29,75,11
113,Yolo,2010,30,9,19,58,9
113,Yolo,2011,20,8,28,56,15
113,Yolo,2012,39,13,54,106,6
113,Yolo,2013,23,16,27,66,9
113,Yolo,2014,32,8,32,72,10
113,Yolo,2015,16,6,18,40,4
113,Yolo,2016,36,6,10,52,17
113,Yolo,2017,39,13,21,73,8
113,Yolo,2018,24,5,22,51,16
113,Yolo,2019,30,15,43,88,26
115,Yuba,1985,24,8,17,49,9
115,Yuba,1986,15,8,30,53,7
115,Yuba,1987,10,10,4,24,8
115,Yuba,1988,18,6,6,30,8
115,Yuba,1989,22,14,15,51,6
115,Yuba,1990,12,12,9,33,6
115,Yuba,1991,12,11,2,25,5
115,Yuba,1992,11,9,4,24,0
115,Yuba,1993,15,8,3,26,9
115,Yuba,1994,16,3,7,26,7
115,Yuba,1995,13,10,10,33,4
115,Yuba,1996,9,5,5,19,1
115,Yuba,1997,12,5,10,27,5
115,Yuba,1998,14,5,10,29,2
115,Yuba,1999,15,7,10,32,5
115,Yuba,2000,12,4,3,19,1
115,Yuba,2001,10,2,11,23,3
115,Yuba,2002,13,4,8,25,4
115,Yuba,2003,11,13,6,30,0
115,Yuba,2004,17,8,7,32,2
115,Yuba,2005,12,5,8,25,1
115,Yuba,2006,13,2,4,19,6
115,Yuba,2007,7,8,6,21,4
115,Yuba,2008,9,0,5,14,2
115,Yuba,2009,11,2,8,21,2
115,Yuba,2010,9,2,5,16,2
115,Yuba,2011,6,3,3,12,1
115,Yuba,2012,17,4,6,27,6
115,Yuba,2013,7,7,5,19,2
115,Yuba,2014,5,9,5,19,2
115,Yuba,2015,8,2,5,15,2
115,Yuba,2016,13,7,7,27,6
115,Yuba,2017,12,10,9,31,1
115,Yuba,2018,14,9,10,33,4
115,Yuba,2019,5,6,9,20,2
